#
# 0 D room2.txt 1
# 1 D room2.txt 0 key1
# 2 E room0.txt 0
#
# k key2
#
WWWW0WWWWW
W      m W
W        W
W   B    W
W        W
W  T   WWW
W      WkW
W      W W
W      W 1
WWWW2WWWWW
