#
# 0 D room1.txt 2
#
WWWW0WWWWW
W        W
W  S     W
WWWWW    W
W   W    W
W   W  WWW
W  H     W
W   f    W
W     h  W
WWWWWWWWWW
