#
# 0 D room1.txt 1
#
WWWW0WWWWW
Wg s s  gW
Wg      gW
Wg      gW
Wg      gW
Wg      gW
Wg      gW
Wg      gW
Wg      gW
WWWWWWWWWW
