WWWW0WWWWW
W        W
W        W
W        W
W        W
W      WWW
W      WkW
W      W W
W      W 1
WWWW2WWWWW