#
# 0 D room3.txt 2
# 1 D room9.txt 0
# 2 E room1.txt 0
#
# k key2
#
WWWW0WWWWW
Wf     S W
W        W
W        W
W   B    W
W      WWW
W      WkW
W      W W
W      W 1
WWWW2WWWWW