#
# 0 D room2.txt 2
# 1 E room0.txt 0
#
WWWW0WWWWW
W        W
W S      W
W        W
WWWW     W
W  W     W
W  W  WWWW
W        W
W        W
WWWW1WWWWW
